1111111111111
10010000000C1
10100111110T1
1P0011E000001
1111111111111
